Ashi Barai – Foot Sweep
Fumikomi – Stomp or Stomping Kick
Gedan Mawashi Geri – Low Roundhouse Kick
Hiza Geri – Knee Strike
Kakato Otoshi Geri – Axe Kick – Sometimes only referred to as Kakato Geri.
Kansetsu Geri – Joint Kick (usually attacking an opponent’s knee)
Kin Geri – Groin Kick
Tobi Geri – Jumping Kick
Tobi Hiza Geri – Jumping Knee Strike
Tobi Mae Geri – Jumping Front Kick
Tobi Mawashi Geri – Jumping Roundhouse Kick
Tobi Ushiro Geri – Jumping Back Kick
Tobi Yoko Geri – Jumping Side Kick or Flying Side Kick
Tsumasaki Geri – Toe Kick
Uchi Haisoku Geri – Twist Kick, Instep Kick, etc.
Ura Mawashi Geri – Reverse Roundhouse Kick or Hook Kick
Age Zuki – Uppercut Punch or Rising Punch
Choku Zuki – Straight Punch
Enpi Uchi – Elbow Strike
Gyaku Zuki – Reverse Punch
Haishu Uchi – Back Hand Strike
Haito Uchi – Ridge Hand Strike
Hasami Zuki – Scissor Punch
Heiko Zuki – Parallel Punch
Ippon Ken – One Finger Strike
Nihon Ken – Two Finger Strike
Kage Zuki – Hook Punch
Kizami Zuki – Jab Punch (also
Mawashi Zuki – Roundhouse Punch
Shuto Uchi – Knife Hand Strike
Tate Zuki – Vertical Punch
Teisho Uchi – Palm Heel Strike
Tobikomi Zuki – Snap Punch
Uraken Uchi – Back Fist Strike
Ura Zuki – Upside-Down Punch or Inverted Punch (To The Solar Plexus)
Yama Zuki – Two-Level Double Punch or Mountain Punch